1 1 1 1 1 1 1 1 1 1 1 3 3 3 3 3 3 3
1 0 0 0 0 0 0 0 0 1 0 0 3 0 0 0 0 3
1 0 0 0 0 0 0 0 0 1 0 0 3 0 0 0 0 3
1 0 0 0 0 0 0 0 0 1 0 0 3 0 0 0 0 3
1 0 0 0 0 0 0 0 0 1 0 0 3 0 0 0 0 3
1 0 0 0 0 0 0 0 0 {1,3,3,1} 3 3 3 0 0 0 0 3
1 0 0 0 0 0 0 0 0 0 0 0 0 0 0 0 0 3
1 0 0 0 0 0 0 0 0 0 0 0 0 0 0 0 0 3
1 0 0 0 0 0 0 0 0 {3,3,1,1} 3 3 3 0 0 0 0 3
1 0 0 0 {8,7,5,6} 0 0 0 0 {1,3,1,1} 0 0 0 0 0 0 0 3
1 0 0 0 0 0 0 0 0 {1,3,1,1} 0 0 0 0 0 0 0 3
1 0 0 0 0 0 0 0 0 {1,3,1,1} 0 0 0 0 0 0 0 3
1 1 {1,4,4,1} 0 0 {1,1,4,4} 1 1 1 2 0 0 0 0 {3,3,6,3} 0 0 3
4 0 4 0 0 4 0 0 0 2 0 0 {6,2,2,2} 0 0 0 0 3
4 0 4 0 0 4 0 0 0 2 0 0 2 0 0 0 0 3
4 0 4 0 0 0 0 0 0 2 0 0 2 0 0 0 0 3
4 0 4 0 0 4 0 0 0 2 0 0 2 0 0 0 0 3
4 0 4 0 0 4 0 0 0 2 0 0 6 0 0 0 0 3
4 0 4 0 0 4 4 4 4 4 0 0 2 2 6 6 2 3
4 0 4 0 0 0 0 0 0 0 0 0 4 0 0 0 0 4
4 0 4 0 0 0 0 0 0 0 0 0 4 0 0 0 0 4
4 4 4 4 4 4 4 4 4 4 4 4 4 4 4 4 4 4